XXXXXXXXXX
XE       X
XXXX XXX X
XE       X
X X  XXXXX
X X    XEX
X XXX  X X
X  X   X X
XX   XP  X
XXXXXXXXXX