XXXXXXXXXX
XE      EX
X    XXX X
X XX     X
X X  XXXXX
X X      X
X XXX  X X
X  X   X X
XX   XEXPX
XXXXXXXXXX