XXXXXXXXXX
X PX X X X
X XX     X
X    XXX X
X   EX   X
X XXXX XXX
X    X  EX
XXX XX XXX
XE  X   EX
XXXXXXXXXX
