XXXXXXXXXX
XE X XEX X
XX XXX   X
X    XXX X
XE     X X
X XXXX X X
X    X   X
XXX XX XXX
XP  XE   X
XXXXXXXXXX
