XXXXXXXXXX
XE       X
XXXXXXXXEX
XE    EX X
X XXXX X X
X X PX X X
X X    X X
X XXXXXX X
X    E   X
XXXXXXXXXX