XXXXXXXXXX
XE      PX
X XXXXXXXX
X XE    EX
X X XXXX X
X X XE X X
X X    X X
X XXXXXX X
X        X
XXXXXXXXXX